#
#   0 1 2 3 4 5 6 7 8 9
#  ---------------------
# 0| |*| | | | | | | |G|
#  ---------------------
# 1| |*| | | | | | | | |
#  ---------------------
# 2| | | | | | |*| | | |
#  ---------------------
# 3| | | |*| | |*| | | |
#  ---------------------
# 4| | | | |*| |*| | | |
#  ---------------------
# 5|I| | | | |*| | | | |
#  ---------------------

6 10
 *       G
 *
      *
   *  *
    * *
I    *
